# # # # # # # # # # # # # # # # # # # # # # # # # # # # # # # # # # # # # # # #
# . . o % T % o . . # . . . . . . . . . . . . . . . . . . . . . # . . . % % T #
# . . o % T % o . . # . . . . . . . . . . . . . . . . . . . . . # . . . . % % #
# . . o % % % o . . # . . . . . . . . . . . . . . . . . . . . . # # . . . . % #
# . . o . . . o . . # . . . . . . . . . . . . . . . . . . . . . . . . . . . . #
# . . o . . . o . . # . . . . . . . # # # # # # # # # # # # . . . . . . . . . #
# . . o . . . o . . # . . . . . . . # . . . . # . . . . . * . . . . . . # . . #
# . . . . . . . . . # . . . . . . . # . . . . # # # # # # # . . . . . . # # # #
# # # # . . . # # # # . . . . . . . # . . . . . . . . . . = . . . . . . . . . #
# . . . . . . . . . . . . . . . . . # . . . . . . . . . . # . . . . . . . . . #
# . . . . . . . . . . . . . . . . . # . . . . . . . . . . # . . . . . . . . . #
# . . . . . . . . . . . . . . . . . # . . . . . . . . . . # . . . . . . . . . #
# # # # # # # # # # # . . . . . . . # . . . . . . . . . . # . . . . . . . . . #
# . . . . . . . . . . . . . . . . . # # # # # . . # # # # # . . . . . . . . . #
# . . . . . . . . . . . . . . . . . . . . . # . . # . . . . . . . . . . . . . #
# . . . . . . . . . . . . . . . . . . . . . # . . # . . . . . . . . . . . . . #
# . . . . . . O . . . . . . . . . . . . . . # . . # . . . . . . . . . . . . . #
# . . . . . . . . . . . . . . . . . . . . . # . . # . . . . . . . . . . . . . #
# . . . . . . . . . . . . . . . . . . . . . # . . # # # # . . . . . . . . . . #
# . . . . . . . . . . . . . . . . . . . . . # . . . . . # . . . . . . . . . . #
# . . . . . . . . . . . . . . . O . . . . . # . . . . . # . . . . . . . . . . #
# # # # . . . . . . . . . . . . . . . . . . # # # # . . # . . . . . . . . . . #
# . . . # . . . . . . . . . . . . . . . . . . . . # . . # . . . . . . . . . . #
# . . . . # . . . . . O . . . . . . . . . . . . . # . . # . . . . . . . . . . #
# . . . . . # . . . . . . . . . . . . . . . . . . # . . # . . . . . . . . . . #
# . . . . . . # . . . . . . . . . . . . . . . . . # . . # . . . . . . . . . . #
# . . . . . . . # . . . . . . . . . . . . . . . . # . . # . . . . . . . . . . #
# . . . . . . . . # # # # # # # # # # # = # # # # # o o # . . . . . . . . . . #
# . . . . . . . . . . . . . . . . . . . . . . . . . . . . . . . . . . . . . . #
# . . . . . . . . . . . . . . . . . . . . . . . . . . . . . . . . . . . . . . #
# . . . . . . . . . . . . . . . . . . . . . . . . . . . . . . . . . . . . . . #
# . . . . . . . . . . . . . . . . . . . . . . . . . . . . . . . . . . . . . . #
# . . . . . . . . . . . . . . . . . . . . . . . . . . . . . . . . . . . . . . #
# . . . . . . . . . . . . . . . . . . . . . . . . . . . . . . . . . . # . # # #
# . . . . . . . . . . . . . . . . . . . . . . . . . . . . . . . . . . # . . . #
# . . . . . . . . . . . . . . . . . . . . . . . . . . . . . . . . . . # . . . #
# . . . . . . . . . . . . . . . . . . . . . . . . . . . . . . . . . . # . . . #
# . . . . . . . . . . . . . . . . . . . . . . . . . . . . . . . . . . # . . . #
# . . . . . . . . . . . . . . . . . . . . . . . . . . . . . . . . . . # . . . #
# # # # # # # # # # # # # # # # # # # # # # # # # # # # # # # # # # # # # # # #
